5 1 1 1 1 1 1 5 1 1 1 1 1 1 1 5 5 1 1 1 1 1 1 5 1 1 1 1 1 1 1 5 5 1 1 1 1 1 1 5 1 1 1 1 1 1 1 5 5 1 1 1 1 1 1 5 1 1 1 1 1 1 1 5 5 1 1 1 1 1 1 5 1 1 1 1 1 1 1 5 5 1 1 1 1 1 1 5 1 1 1 1 1 1 1 5 5 1 1 1
11 7 7 7 7 7 7 11 7 7 7 7 7 7 7 11 11 7 7 7 7 7 7 11 7 7 7 7 7 7 7 11 11 7 7 7 7 7 7 11 7 7 7 7 7 7 7 11 11 7 7 7 7 7 7 11 7 7 7 7 7 7 7 11 11 7 7 7 7 7 7 11 7 7 7 7 7 7 7 11 11 7 7 7 7 7 7 11 7 7 7 7 7 7 7 11 11 7 7 7
7 25 25 25 25 25 25 25 25 25 25 25 25 25 25 25 7 25 25 25 25 25 25 25 25 25 25 25 25 25 25 25 7 25 25 25 25 25 25 25 25 25 25 25 25 25 25 25 7 25 25 25 25 25 25 25 25 25 25 25 25 25 25 25 7 25 25 25 25 25 25 25 25 25 25 25 25 25 25 25 7 25 25 25 25 25 25 25 25 25 25 25 25 25 25 25 7 25 25 25
7 25 26 25 25 25 25 25 25 25 25 26 25 25 25 25 7 25 26 25 25 25 25 25 25 25 25 26 25 25 25 25 7 25 26 25 25 25 25 25 25 25 25 26 25 25 25 25 7 25 26 25 25 25 25 25 25 25 25 26 25 25 25 25 7 25 26 25 25 25 25 25 25 25 25 26 25 25 25 25 7 25 26 25 25 25 25 25 25 25 25 26 25 25 25 25 7 25 26 25
7 25 25 25 25 25 25 25 25 25 25 25 25 25 25 25 7 25 25 25 25 25 25 25 25 25 25 25 25 25 25 25 7 25 25 25 25 25 25 25 25 25 25 25 25 25 25 25 7 25 25 25 25 25 25 25 25 25 25 25 25 25 25 25 7 25 25 25 25 25 25 25 25 25 25 25 25 25 25 25 7 25 25 25 25 25 25 25 25 25 25 25 25 25 25 25 7 25 25 25
7 25 25 25 25 26 25 25 25 25 26 25 25 25 25 25 7 25 25 25 25 26 25 25 25 25 26 25 25 25 25 25 7 25 25 25 25 26 25 25 25 25 26 25 25 25 25 25 7 25 25 25 25 26 25 25 25 25 26 25 25 25 25 25 7 25 25 25 25 26 25 25 25 25 26 25 25 25 25 25 7 25 25 25 25 26 25 25 25 25 26 25 25 25 25 25 7 25 25 25
7 25 25 25 25 25 25 25 25 25 25 25 25 25 25 25 7 25 25 25 25 25 25 25 25 25 25 25 25 25 25 25 7 25 25 25 25 25 25 25 25 25 25 25 25 25 25 25 7 25 25 25 25 25 25 25 25 25 25 25 25 25 25 25 7 25 25 25 25 25 25 25 25 25 25 25 25 25 25 25 7 25 25 25 25 25 25 25 25 25 25 25 25 25 25 25 7 25 25 25
7 25 26 25 25 25 25 25 25 25 25 25 26 25 25 25 7 25 26 25 25 25 25 25 25 25 25 25 26 25 25 25 7 25 26 25 25 25 25 25 25 25 25 25 26 25 25 25 7 25 26 25 25 25 25 25 25 25 25 25 26 25 25 25 7 25 26 25 25 25 25 25 25 25 25 25 26 25 25 25 7 25 26 25 25 25 25 25 25 25 25 25 26 25 25 25 7 25 26 25
7 25 25 25 25 25 25 25 25 25 25 25 25 25 25 25 7 25 25 25 25 25 25 25 25 25 25 25 25 25 25 25 7 25 25 25 25 25 25 25 25 25 25 25 25 25 25 25 7 25 25 25 25 25 25 25 25 25 25 25 25 25 25 25 7 25 25 25 25 25 25 25 25 25 25 25 25 25 25 25 7 25 25 25 25 25 25 25 25 25 25 25 25 25 25 25 7 25 25 25
7 25 25 25 25 25 25 25 25 25 25 25 25 25 25 25 7 25 25 25 25 25 25 25 25 25 25 25 25 25 25 25 7 25 25 25 25 25 25 25 25 25 25 25 25 25 25 25 7 25 25 25 25 25 25 25 25 25 25 25 25 25 25 25 7 25 25 25 25 25 25 25 25 25 25 25 25 25 25 25 7 25 25 25 25 25 25 25 25 25 25 25 25 25 25 25 7 25 25 25
7 25 25 25 25 25 25 25 25 25 25 25 25 25 25 25 7 25 25 25 25 25 25 25 25 25 25 25 25 25 25 25 7 25 25 25 25 25 25 25 25 25 25 25 25 25 25 25 7 25 25 25 25 25 25 25 25 25 25 25 25 25 25 25 7 25 25 25 25 25 25 25 25 25 25 25 25 25 25 25 7 25 25 25 25 25 25 25 25 25 25 25 25 25 25 25 7 25 25 25
7 25 25 25 25 25 25 25 25 25 25 25 25 25 25 25 7 25 25 25 25 25 25 25 25 25 25 25 25 25 25 25 7 25 25 25 25 25 25 25 25 25 25 25 25 25 25 25 7 25 25 25 25 25 25 25 25 25 25 25 25 25 25 25 7 25 25 25 25 25 25 25 25 25 25 25 25 25 25 25 7 25 25 25 25 25 25 25 25 25 25 25 25 25 25 25 7 25 25 25
5 1 1 1 1 1 1 5 1 1 1 1 1 1 1 5 5 1 1 1 1 1 1 5 1 1 1 1 1 1 1 5 5 1 1 1 1 1 1 5 1 1 1 1 1 1 1 5 5 1 1 1 1 1 1 5 1 1 1 1 1 1 1 5 5 1 1 1 1 1 1 5 1 1 1 1 1 1 1 5 5 1 1 1 1 1 1 5 1 1 1 1 1 1 1 5 5 1 1 1
11 7 7 7 7 7 7 11 7 7 7 7 7 7 7 11 11 7 7 7 7 7 7 11 7 7 7 7 7 7 7 11 11 7 7 7 7 7 7 11 7 7 7 7 7 7 7 11 11 7 7 7 7 7 7 11 7 7 7 7 7 7 7 11 11 7 7 7 7 7 7 11 7 7 7 7 7 7 7 11 11 7 7 7 7 7 7 11 7 7 7 7 7 7 7 11 11 7 7 7
7 25 25 25 25 25 25 25 25 25 25 25 25 25 25 25 7 25 25 25 25 25 25 25 25 25 25 25 25 25 25 25 7 25 25 25 25 25 25 25 25 25 25 25 25 25 25 25 7 25 25 25 25 25 25 25 25 25 25 25 25 25 25 25 7 25 25 25 25 25 25 25 25 25 25 25 25 25 25 25 7 25 25 25 25 25 25 25 25 25 25 25 25 25 25 25 7 25 25 25
7 25 26 25 25 25 25 25 25 25 25 26 25 25 25 25 7 25 26 25 25 25 25 25 25 25 25 26 25 25 25 25 7 25 26 25 25 25 25 25 25 25 25 26 25 25 25 25 7 25 26 25 25 25 25 25 25 25 25 26 25 25 25 25 7 25 26 25 25 25 25 25 25 25 25 26 25 25 25 25 7 25 26 25 25 25 25 25 25 25 25 26 25 25 25 25 7 25 26 25
7 25 25 25 25 25 25 25 25 25 25 25 25 25 25 25 7 25 25 25 25 25 25 25 25 25 25 25 25 25 25 25 7 25 25 25 25 25 25 25 25 25 25 25 25 25 25 25 7 25 25 25 25 25 25 25 25 25 25 25 25 25 25 25 7 25 25 25 25 25 25 25 25 25 25 25 25 25 25 25 7 25 25 25 25 25 25 25 25 25 25 25 25 25 25 25 7 25 25 25
7 25 25 25 25 26 25 25 25 25 26 25 25 25 25 25 7 25 25 25 25 26 25 25 25 25 26 25 25 25 25 25 7 25 25 25 25 26 25 25 25 25 26 25 25 25 25 25 7 25 25 25 25 26 25 25 25 25 26 25 25 25 25 25 7 25 25 25 25 26 25 25 25 25 26 25 25 25 25 25 7 25 25 25 25 26 25 25 25 25 26 25 25 25 25 25 7 25 25 25
7 25 25 25 25 25 25 25 25 25 25 25 25 25 25 25 7 25 25 25 25 25 25 25 25 25 25 25 25 25 25 25 7 25 25 25 25 25 25 25 25 25 25 25 25 25 25 25 7 25 25 25 25 25 25 25 25 25 25 25 25 25 25 25 7 25 25 25 25 25 25 25 25 25 25 25 25 25 25 25 7 25 25 25 25 25 25 25 25 25 25 25 25 25 25 25 7 25 25 25
7 25 26 25 25 25 25 25 25 25 25 25 26 25 25 25 7 25 26 25 25 25 25 25 25 25 25 25 26 25 25 25 7 25 26 25 25 25 25 25 25 25 25 25 26 25 25 25 7 25 26 25 25 25 25 25 25 25 25 25 26 25 25 25 7 25 26 25 25 25 25 25 25 25 25 25 26 25 25 25 7 25 26 25 25 25 25 25 25 25 25 25 26 25 25 25 7 25 26 25
7 25 25 25 25 25 25 25 25 25 25 25 25 25 25 25 7 25 25 25 25 25 25 25 25 25 25 25 25 25 25 25 7 25 25 25 25 25 25 25 25 25 25 25 25 25 25 25 7 25 25 25 25 25 25 25 25 25 25 25 25 25 25 25 7 25 25 25 25 25 25 25 25 25 25 25 25 25 25 25 7 25 25 25 25 25 25 25 25 25 25 25 25 25 25 25 7 25 25 25
7 25 25 25 25 25 25 25 25 25 25 25 25 25 25 25 7 25 25 25 25 25 25 25 25 25 25 25 25 25 25 25 7 25 25 25 25 25 25 25 25 25 25 25 25 25 25 25 7 25 25 25 25 25 25 25 25 25 25 25 25 25 25 25 7 25 25 25 25 25 25 25 25 25 25 25 25 25 25 25 7 25 25 25 25 25 25 25 25 25 25 25 25 25 25 25 7 25 25 25
7 25 25 25 25 25 25 25 25 25 25 25 25 25 25 25 7 25 25 25 25 25 25 25 25 25 25 25 25 25 25 25 7 25 25 25 25 25 25 25 25 25 25 25 25 25 25 25 7 25 25 25 25 25 25 25 25 25 25 25 25 25 25 25 7 25 25 25 25 25 25 25 25 25 25 25 25 25 25 25 7 25 25 25 25 25 25 25 25 25 25 25 25 25 25 25 7 25 25 25
7 25 25 25 25 25 25 25 25 25 25 25 25 25 25 25 7 25 25 25 25 25 25 25 25 25 25 25 25 25 25 25 7 25 25 25 25 25 25 25 25 25 25 25 25 25 25 25 7 25 25 25 25 25 25 25 25 25 25 25 25 25 25 25 7 25 25 25 25 25 25 25 25 25 25 25 25 25 25 25 7 25 25 25 25 25 25 25 25 25 25 25 25 25 25 25 7 25 25 25
5 1 1 1 1 1 1 5 1 1 1 1 1 1 1 5 5 1 1 1 1 1 1 5 1 1 1 1 1 1 1 5 5 1 1 1 1 1 1 5 1 1 1 1 1 1 1 5 5 1 1 1 1 1 1 5 1 1 1 1 1 1 1 5 5 1 1 1 1 1 1 5 1 1 1 1 1 1 1 5 5 1 1 1 1 1 1 5 1 1 1 1 1 1 1 5 5 1 1 1
11 7 7 7 7 7 7 11 7 7 7 7 7 7 7 11 11 7 7 7 7 7 7 11 7 7 7 7 7 7 7 11 11 7 7 7 7 7 7 11 7 7 7 7 7 7 7 11 11 7 7 7 7 7 7 11 7 7 7 7 7 7 7 11 11 7 7 7 7 7 7 11 7 7 7 7 7 7 7 11 11 7 7 7 7 7 7 11 7 7 7 7 7 7 7 11 11 7 7 7
7 25 25 25 25 25 25 25 25 25 25 25 25 25 25 25 7 25 25 25 25 25 25 25 25 25 25 25 25 25 25 25 7 25 25 25 25 25 25 25 25 25 25 25 25 25 25 25 7 25 25 25 25 25 25 25 25 25 25 25 25 25 25 25 7 25 25 25 25 25 25 25 25 25 25 25 25 25 25 25 7 25 25 25 25 25 25 25 25 25 25 25 25 25 25 25 7 25 25 25
7 25 26 25 25 25 25 25 25 25 25 26 25 25 25 25 7 25 26 25 25 25 25 25 25 25 25 26 25 25 25 25 7 25 26 25 25 25 25 25 25 25 25 26 25 25 25 25 7 25 26 25 25 25 25 25 25 25 25 26 25 25 25 25 7 25 26 25 25 25 25 25 25 25 25 26 25 25 25 25 7 25 26 25 25 25 25 25 25 25 25 26 25 25 25 25 7 25 26 25
7 25 25 25 25 25 25 25 25 25 25 25 25 25 25 25 7 25 25 25 25 25 25 25 25 25 25 25 25 25 25 25 7 25 25 25 25 25 25 25 25 25 25 25 25 25 25 25 7 25 25 25 25 25 25 25 25 25 25 25 25 25 25 25 7 25 25 25 25 25 25 25 25 25 25 25 25 25 25 25 7 25 25 25 25 25 25 25 25 25 25 25 25 25 25 25 7 25 25 25
7 25 25 25 25 26 25 25 25 25 26 25 25 25 25 25 7 25 25 25 25 26 25 25 25 25 26 25 25 25 25 25 7 25 25 25 25 26 25 25 25 25 26 25 25 25 25 25 7 25 25 25 25 26 25 25 25 25 26 25 25 25 25 25 7 25 25 25 25 26 25 25 25 25 26 25 25 25 25 25 7 25 25 25 25 26 25 25 25 25 26 25 25 25 25 25 7 25 25 25
7 25 25 25 25 25 25 25 25 25 25 25 25 25 25 25 7 25 25 25 25 25 25 25 25 25 25 25 25 25 25 25 7 25 25 25 25 25 25 25 25 25 25 25 25 25 25 25 7 25 25 25 25 25 25 25 25 25 25 25 25 25 25 25 7 25 25 25 25 25 25 25 25 25 25 25 25 25 25 25 7 25 25 25 25 25 25 25 25 25 25 25 25 25 25 25 7 25 25 25
7 25 26 25 25 25 25 25 25 25 25 25 26 25 25 25 7 25 26 25 25 25 25 25 25 25 25 25 26 25 25 25 7 25 26 25 25 25 25 25 25 25 25 25 26 25 25 25 7 25 26 25 25 25 25 25 25 25 25 25 26 25 25 25 7 25 26 25 25 25 25 25 25 25 25 25 26 25 25 25 7 25 26 25 25 25 25 25 25 25 25 25 26 25 25 25 7 25 26 25
7 25 25 25 25 25 25 25 25 25 25 25 25 25 25 25 7 25 25 25 25 25 25 25 25 25 25 25 25 25 25 25 7 25 25 25 25 25 25 25 25 25 25 25 25 25 25 25 7 25 25 25 25 25 25 25 25 25 25 25 25 25 25 25 7 25 25 25 25 25 25 25 25 25 25 25 25 25 25 25 7 25 25 25 25 25 25 25 25 25 25 25 25 25 25 25 7 25 25 25
7 25 25 25 25 25 25 25 25 25 25 25 25 25 25 25 7 25 25 25 25 25 25 25 25 25 25 25 25 25 25 25 7 25 25 25 25 25 25 25 25 25 25 25 25 25 25 25 7 25 25 25 25 25 25 25 25 25 25 25 25 25 25 25 7 25 25 25 25 25 25 25 25 25 25 25 25 25 25 25 7 25 25 25 25 25 25 25 25 25 25 25 25 25 25 25 7 25 25 25
7 25 25 25 25 25 25 25 25 25 25 25 25 25 25 25 7 25 25 25 25 25 25 25 25 25 25 25 25 25 25 25 7 25 25 25 25 25 25 25 25 25 25 25 25 25 25 25 7 25 25 25 25 25 25 25 25 25 25 25 25 25 25 25 7 25 25 25 25 25 25 25 25 25 25 25 25 25 25 25 7 25 25 25 25 25 25 25 25 25 25 25 25 25 25 25 7 25 25 25
7 25 25 25 25 25 25 25 25 25 25 25 25 25 25 25 7 25 25 25 25 25 25 25 25 25 25 25 25 25 25 25 7 25 25 25 25 25 25 25 25 25 25 25 25 25 25 25 7 25 25 25 25 25 25 25 25 25 25 25 25 25 25 25 7 25 25 25 25 25 25 25 25 25 25 25 25 25 25 25 7 25 25 25 25 25 25 25 25 25 25 25 25 25 25 25 7 25 25 25
5 1 1 1 1 1 1 5 1 1 1 1 1 1 1 5 5 1 1 1 1 1 1 5 1 1 1 1 1 1 1 5 5 1 1 1 1 1 1 5 1 1 1 1 1 1 1 5 5 1 1 1 1 1 1 5 1 1 1 1 1 1 1 5 5 1 1 1 1 1 1 5 1 1 1 1 1 1 1 5 5 1 1 1 1 1 1 5 1 1 1 1 1 1 1 5 5 1 1 1
11 7 7 7 7 7 7 11 7 7 7 7 7 7 7 11 11 7 7 7 7 7 7 11 7 7 7 7 7 7 7 11 11 7 7 7 7 7 7 11 7 7 7 7 7 7 7 11 11 7 7 7 7 7 7 11 7 7 7 7 7 7 7 11 11 7 7 7 7 7 7 11 7 7 7 7 7 7 7 11 11 7 7 7 7 7 7 11 7 7 7 7 7 7 7 11 11 7 7 7
7 25 25 25 25 25 25 25 25 25 25 25 25 25 25 25 7 25 25 25 25 25 25 25 25 25 25 25 25 25 25 25 7 25 25 25 25 25 25 25 25 25 25 25 25 25 25 25 7 25 25 25 25 25 25 25 25 25 25 25 25 25 25 25 7 25 25 25 25 25 25 25 25 25 25 25 25 25 25 25 7 25 25 25 25 25 25 25 25 25 25 25 25 25 25 25 7 25 25 25
7 25 26 25 25 25 25 25 25 25 25 26 25 25 25 25 7 25 26 25 25 25 25 25 25 25 25 26 25 25 25 25 7 25 26 25 25 25 25 25 25 25 25 26 25 25 25 25 7 25 26 25 25 25 25 25 25 25 25 26 25 25 25 25 7 25 26 25 25 25 25 25 25 25 25 26 25 25 25 25 7 25 26 25 25 25 25 25 25 25 25 26 25 25 25 25 7 25 26 25
7 25 25 25 25 25 25 25 25 25 25 25 25 25 25 25 7 25 25 25 25 25 25 25 25 25 25 25 25 25 25 25 7 25 25 25 25 25 25 25 25 25 25 25 25 25 25 25 7 25 25 25 25 25 25 25 25 25 25 25 25 25 25 25 7 25 25 25 25 25 25 25 25 25 25 25 25 25 25 25 7 25 25 25 25 25 25 25 25 25 25 25 25 25 25 25 7 25 25 25
7 25 25 25 25 26 25 25 25 25 26 25 25 25 25 25 7 25 25 25 25 26 25 25 25 25 26 25 25 25 25 25 7 25 25 25 25 26 25 25 25 25 26 25 25 25 25 25 7 25 25 25 25 26 25 25 25 25 26 25 25 25 25 25 7 25 25 25 25 26 25 25 25 25 26 25 25 25 25 25 7 25 25 25 25 26 25 25 25 25 26 25 25 25 25 25 7 25 25 25
7 25 25 25 25 25 25 25 25 25 25 25 25 25 25 25 7 25 25 25 25 25 25 25 25 25 25 25 25 25 25 25 7 25 25 25 25 25 25 25 25 25 25 25 25 25 25 25 7 25 25 25 25 25 25 25 25 25 25 25 25 25 25 25 7 25 25 25 25 25 25 25 25 25 25 25 25 25 25 25 7 25 25 25 25 25 25 25 25 25 25 25 25 25 25 25 7 25 25 25
7 25 26 25 25 25 25 25 25 25 25 25 26 25 25 25 7 25 26 25 25 25 25 25 25 25 25 25 26 25 25 25 7 25 26 25 25 25 25 25 25 25 25 25 26 25 25 25 7 25 26 25 25 25 25 25 25 25 25 25 26 25 25 25 7 25 26 25 25 25 25 25 25 25 25 25 26 25 25 25 7 25 26 25 25 25 25 25 25 25 25 25 26 25 25 25 7 25 26 25
7 25 25 25 25 25 25 25 25 25 25 25 25 25 25 25 7 25 25 25 25 25 25 25 25 25 25 25 25 25 25 25 7 25 25 25 25 25 25 25 25 25 25 25 25 25 25 25 7 25 25 25 25 25 25 25 25 25 25 25 25 25 25 25 7 25 25 25 25 25 25 25 25 25 25 25 25 25 25 25 7 25 25 25 25 25 25 25 25 25 25 25 25 25 25 25 7 25 25 25
7 25 25 25 25 25 25 25 25 25 25 25 25 25 25 25 7 25 25 25 25 25 25 25 25 25 25 25 25 25 25 25 7 25 25 25 25 25 25 25 25 25 25 25 25 25 25 25 7 25 25 25 25 25 25 25 25 25 25 25 25 25 25 25 7 25 25 25 25 25 25 25 25 25 25 25 25 25 25 25 7 25 25 25 25 25 25 25 25 25 25 25 25 25 25 25 7 25 25 25
7 25 25 25 25 25 25 25 25 25 25 25 25 25 25 25 7 25 25 25 25 25 25 25 25 25 25 25 25 25 25 25 7 25 25 25 25 25 25 25 25 25 25 25 25 25 25 25 7 25 25 25 25 25 25 25 25 25 25 25 25 25 25 25 7 25 25 25 25 25 25 25 25 25 25 25 25 25 25 25 7 25 25 25 25 25 25 25 25 25 25 25 25 25 25 25 7 25 25 25
7 25 25 25 25 25 25 25 25 25 25 25 25 25 25 25 7 25 25 25 25 25 25 25 25 25 25 25 25 25 25 25 7 25 25 25 25 25 25 25 25 25 25 25 25 25 25 25 7 25 25 25 25 25 25 25 25 25 25 25 25 25 25 25 7 25 25 25 25 25 25 25 25 25 25 25 25 25 25 25 7 25 25 25 25 25 25 25 25 25 25 25 25 25 25 25 7 25 25 25
5 1 1 1 1 1 1 5 1 1 1 1 1 1 1 5 5 1 1 1 1 1 1 5 1 1 1 1 1 1 1 5 5 1 1 1 1 1 1 5 1 1 1 1 1 1 1 5 5 1 1 1 1 1 1 5 1 1 1 1 1 1 1 5 5 1 1 1 1 1 1 5 1 1 1 1 1 1 1 5 5 1 1 1 1 1 1 5 1 1 1 1 1 1 1 5 5 1 1 1
11 7 7 7 7 7 7 11 7 7 7 7 7 7 7 11 11 7 7 7 7 7 7 11 7 7 7 7 7 7 7 11 11 7 7 7 7 7 7 11 7 7 7 7 7 7 7 11 11 7 7 7 7 7 7 11 7 7 7 7 7 7 7 11 11 7 7 7 7 7 7 11 7 7 7 7 7 7 7 11 11 7 7 7 7 7 7 11 7 7 7 7 7 7 7 11 11 7 7 7
7 25 25 25 25 25 25 25 25 25 25 25 25 25 25 25 7 25 25 25 25 25 25 25 25 25 25 25 25 25 25 25 7 25 25 25 25 25 25 25 25 25 25 25 25 25 25 25 7 25 25 25 25 25 25 25 25 25 25 25 25 25 25 25 7 25 25 25 25 25 25 25 25 25 25 25 25 25 25 25 7 25 25 25 25 25 25 25 25 25 25 25 25 25 25 25 7 25 25 25
7 25 26 25 25 25 25 25 25 25 25 26 25 25 25 25 7 25 26 25 25 25 25 25 25 25 25 26 25 25 25 25 7 25 26 25 25 25 25 25 25 25 25 26 25 25 25 25 7 25 26 25 25 25 25 25 25 25 25 26 25 25 25 25 7 25 26 25 25 25 25 25 25 25 25 26 25 25 25 25 7 25 26 25 25 25 25 25 25 25 25 26 25 25 25 25 7 25 26 25
7 25 25 25 25 25 25 25 25 25 25 25 25 25 25 25 7 25 25 25 25 25 25 25 25 25 25 25 25 25 25 25 7 25 25 25 25 25 25 25 25 25 25 25 25 25 25 25 7 25 25 25 25 25 25 25 25 25 25 25 25 25 25 25 7 25 25 25 25 25 25 25 25 25 25 25 25 25 25 25 7 25 25 25 25 25 25 25 25 25 25 25 25 25 25 25 7 25 25 25
7 25 25 25 25 26 25 25 25 25 26 25 25 25 25 25 7 25 25 25 25 26 25 25 25 25 26 25 25 25 25 25 7 25 25 25 25 26 25 25 25 25 26 25 25 25 25 25 7 25 25 25 25 26 25 25 25 25 26 25 25 25 25 25 7 25 25 25 25 26 25 25 25 25 26 25 25 25 25 25 7 25 25 25 25 26 25 25 25 25 26 25 25 25 25 25 7 25 25 25
7 25 25 25 25 25 25 25 25 25 25 25 25 25 25 25 7 25 25 25 25 25 25 25 25 25 25 25 25 25 25 25 7 25 25 25 25 25 25 25 25 25 25 25 25 25 25 25 7 25 25 25 25 25 25 25 25 25 25 25 25 25 25 25 7 25 25 25 25 25 25 25 25 25 25 25 25 25 25 25 7 25 25 25 25 25 25 25 25 25 25 25 25 25 25 25 7 25 25 25
7 25 26 25 25 25 25 25 25 25 25 25 26 25 25 25 7 25 26 25 25 25 25 25 25 25 25 25 26 25 25 25 7 25 26 25 25 25 25 25 25 25 25 25 26 25 25 25 7 25 26 25 25 25 25 25 25 25 25 25 26 25 25 25 7 25 26 25 25 25 25 25 25 25 25 25 26 25 25 25 7 25 26 25 25 25 25 25 25 25 25 25 26 25 25 25 7 25 26 25
7 25 25 25 25 25 25 25 25 25 25 25 25 25 25 25 7 25 25 25 25 25 25 25 25 25 25 25 25 25 25 25 7 25 25 25 25 25 25 25 25 25 25 25 25 25 25 25 7 25 25 25 25 25 25 25 25 25 25 25 25 25 25 25 7 25 25 25 25 25 25 25 25 25 25 25 25 25 25 25 7 25 25 25 25 25 25 25 25 25 25 25 25 25 25 25 7 25 25 25
7 25 25 25 25 25 25 25 25 25 25 25 25 25 25 25 7 25 25 25 25 25 25 25 25 25 25 25 25 25 25 25 7 25 25 25 25 25 25 25 25 25 25 25 25 25 25 25 7 25 25 25 25 25 25 25 25 25 25 25 25 25 25 25 7 25 25 25 25 25 25 25 25 25 25 25 25 25 25 25 7 25 25 25 25 25 25 25 25 25 25 25 25 25 25 25 7 25 25 25
7 25 25 25 25 25 25 25 25 25 25 25 25 25 25 25 7 25 25 25 25 25 25 25 25 25 25 25 25 25 25 25 7 25 25 25 25 25 25 25 25 25 25 25 25 25 25 25 7 25 25 25 25 25 25 25 25 25 25 25 25 25 25 25 7 25 25 25 25 25 25 25 25 25 25 25 25 25 25 25 7 25 25 25 25 25 25 25 25 25 25 25 25 25 25 25 7 25 25 25
7 25 25 25 25 25 25 25 25 25 25 25 25 25 25 25 7 25 25 25 25 25 25 25 25 25 25 25 25 25 25 25 7 25 25 25 25 25 25 25 25 25 25 25 25 25 25 25 7 25 25 25 25 25 25 25 25 25 25 25 25 25 25 25 7 25 25 25 25 25 25 25 25 25 25 25 25 25 25 25 7 25 25 25 25 25 25 25 25 25 25 25 25 25 25 25 7 25 25 25
5 1 1 1 1 1 1 5 1 1 1 1 1 1 1 5 5 1 1 1 1 1 1 5 1 1 1 1 1 1 1 5 5 1 1 1 1 1 1 5 1 1 1 1 1 1 1 5 5 1 1 1 1 1 1 5 1 1 1 1 1 1 1 5 5 1 1 1 1 1 1 5 1 1 1 1 1 1 1 5 5 1 1 1 1 1 1 5 1 1 1 1 1 1 1 5 5 1 1 1
11 7 7 7 7 7 7 11 7 7 7 7 7 7 7 11 11 7 7 7 7 7 7 11 7 7 7 7 7 7 7 11 11 7 7 7 7 7 7 11 7 7 7 7 7 7 7 11 11 7 7 7 7 7 7 11 7 7 7 7 7 7 7 11 11 7 7 7 7 7 7 11 7 7 7 7 7 7 7 11 11 7 7 7 7 7 7 11 7 7 7 7 7 7 7 11 11 7 7 7
7 25 25 25 25 25 25 25 25 25 25 25 25 25 25 25 7 25 25 25 25 25 25 25 25 25 25 25 25 25 25 25 7 25 25 25 25 25 25 25 25 25 25 25 25 25 25 25 7 25 25 25 25 25 25 25 25 25 25 25 25 25 25 25 7 25 25 25 25 25 25 25 25 25 25 25 25 25 25 25 7 25 25 25 25 25 25 25 25 25 25 25 25 25 25 25 7 25 25 25
7 25 26 25 25 25 25 25 25 25 25 26 25 25 25 25 7 25 26 25 25 25 25 25 25 25 25 26 25 25 25 25 7 25 26 25 25 25 25 25 25 25 25 26 25 25 25 25 7 25 26 25 25 25 25 25 25 25 25 26 25 25 25 25 7 25 26 25 25 25 25 25 25 25 25 26 25 25 25 25 7 25 26 25 25 25 25 25 25 25 25 26 25 25 25 25 7 25 26 25
7 25 25 25 25 25 25 25 25 25 25 25 25 25 25 25 7 25 25 25 25 25 25 25 25 25 25 25 25 25 25 25 7 25 25 25 25 25 25 25 25 25 25 25 25 25 25 25 7 25 25 25 25 25 25 25 25 25 25 25 25 25 25 25 7 25 25 25 25 25 25 25 25 25 25 25 25 25 25 25 7 25 25 25 25 25 25 25 25 25 25 25 25 25 25 25 7 25 25 25
7 25 25 25 25 26 25 25 25 25 26 25 25 25 25 25 7 25 25 25 25 26 25 25 25 25 26 25 25 25 25 25 7 25 25 25 25 26 25 25 25 25 26 25 25 25 25 25 7 25 25 25 25 26 25 25 25 25 26 25 25 25 25 25 7 25 25 25 25 26 25 25 25 25 26 25 25 25 25 25 7 25 25 25 25 26 25 25 25 25 26 25 25 25 25 25 7 25 25 25
7 25 25 25 25 25 25 25 25 25 25 25 25 25 25 25 7 25 25 25 25 25 25 25 25 25 25 25 25 25 25 25 7 25 25 25 25 25 25 25 25 25 25 25 25 25 25 25 7 25 25 25 25 25 25 25 25 25 25 25 25 25 25 25 7 25 25 25 25 25 25 25 25 25 25 25 25 25 25 25 7 25 25 25 25 25 25 25 25 25 25 25 25 25 25 25 7 25 25 25
7 25 26 25 25 25 25 25 25 25 25 25 26 25 25 25 7 25 26 25 25 25 25 25 25 25 25 25 26 25 25 25 7 25 26 25 25 25 25 25 25 25 25 25 26 25 25 25 7 25 26 25 25 25 25 25 25 25 25 25 26 25 25 25 7 25 26 25 25 25 25 25 25 25 25 25 26 25 25 25 7 25 26 25 25 25 25 25 25 25 25 25 26 25 25 25 7 25 26 25
7 25 25 25 25 25 25 25 25 25 25 25 25 25 25 25 7 25 25 25 25 25 25 25 25 25 25 25 25 25 25 25 7 25 25 25 25 25 25 25 25 25 25 25 25 25 25 25 7 25 25 25 25 25 25 25 25 25 25 25 25 25 25 25 7 25 25 25 25 25 25 25 25 25 25 25 25 25 25 25 7 25 25 25 25 25 25 25 25 25 25 25 25 25 25 25 7 25 25 25
7 25 25 25 25 25 25 25 25 25 25 25 25 25 25 25 7 25 25 25 25 25 25 25 25 25 25 25 25 25 25 25 7 25 25 25 25 25 25 25 25 25 25 25 25 25 25 25 7 25 25 25 25 25 25 25 25 25 25 25 25 25 25 25 7 25 25 25 25 25 25 25 25 25 25 25 25 25 25 25 7 25 25 25 25 25 25 25 25 25 25 25 25 25 25 25 7 25 25 25
7 25 25 25 25 25 25 25 25 25 25 25 25 25 25 25 7 25 25 25 25 25 25 25 25 25 25 25 25 25 25 25 7 25 25 25 25 25 25 25 25 25 25 25 25 25 25 25 7 25 25 25 25 25 25 25 25 25 25 25 25 25 25 25 7 25 25 25 25 25 25 25 25 25 25 25 25 25 25 25 7 25 25 25 25 25 25 25 25 25 25 25 25 25 25 25 7 25 25 25
7 25 25 25 25 25 25 25 25 25 25 25 25 25 25 25 7 25 25 25 25 25 25 25 25 25 25 25 25 25 25 25 7 25 25 25 25 25 25 25 25 25 25 25 25 25 25 25 7 25 25 25 25 25 25 25 25 25 25 25 25 25 25 25 7 25 25 25 25 25 25 25 25 25 25 25 25 25 25 25 7 25 25 25 25 25 25 25 25 25 25 25 25 25 25 25 7 25 25 25
5 1 1 1 1 1 1 5 1 1 1 1 1 1 1 5 5 1 1 1 1 1 1 5 1 1 1 1 1 1 1 5 5 1 1 1 1 1 1 5 1 1 1 1 1 1 1 5 5 1 1 1 1 1 1 5 1 1 1 1 1 1 1 5 5 1 1 1 1 1 1 5 1 1 1 1 1 1 1 5 5 1 1 1 1 1 1 5 1 1 1 1 1 1 1 5 5 1 1 1
11 7 7 7 7 7 7 11 7 7 7 7 7 7 7 11 11 7 7 7 7 7 7 11 7 7 7 7 7 7 7 11 11 7 7 7 7 7 7 11 7 7 7 7 7 7 7 11 11 7 7 7 7 7 7 11 7 7 7 7 7 7 7 11 11 7 7 7 7 7 7 11 7 7 7 7 7 7 7 11 11 7 7 7 7 7 7 11 7 7 7 7 7 7 7 11 11 7 7 7
7 25 25 25 25 25 25 25 25 25 25 25 25 25 25 25 7 25 25 25 25 25 25 25 25 25 25 25 25 25 25 25 7 25 25 25 25 25 25 25 25 25 25 25 25 25 25 25 7 25 25 25 25 25 25 25 25 25 25 25 25 25 25 25 7 25 25 25 25 25 25 25 25 25 25 25 25 25 25 25 7 25 25 25 25 25 25 25 25 25 25 25 25 25 25 25 7 25 25 25
7 25 26 25 25 25 25 25 25 25 25 26 25 25 25 25 7 25 26 25 25 25 25 25 25 25 25 26 25 25 25 25 7 25 26 25 25 25 25 25 25 25 25 26 25 25 25 25 7 25 26 25 25 25 25 25 25 25 25 26 25 25 25 25 7 25 26 25 25 25 25 25 25 25 25 26 25 25 25 25 7 25 26 25 25 25 25 25 25 25 25 26 25 25 25 25 7 25 26 25
7 25 25 25 25 25 25 25 25 25 25 25 25 25 25 25 7 25 25 25 25 25 25 25 25 25 25 25 25 25 25 25 7 25 25 25 25 25 25 25 25 25 25 25 25 25 25 25 7 25 25 25 25 25 25 25 25 25 25 25 25 25 25 25 7 25 25 25 25 25 25 25 25 25 25 25 25 25 25 25 7 25 25 25 25 25 25 25 25 25 25 25 25 25 25 25 7 25 25 25
7 25 25 25 25 26 25 25 25 25 26 25 25 25 25 25 7 25 25 25 25 26 25 25 25 25 26 25 25 25 25 25 7 25 25 25 25 26 25 25 25 25 26 25 25 25 25 25 7 25 25 25 25 26 25 25 25 25 26 25 25 25 25 25 7 25 25 25 25 26 25 25 25 25 26 25 25 25 25 25 7 25 25 25 25 26 25 25 25 25 26 25 25 25 25 25 7 25 25 25
7 25 25 25 25 25 25 25 25 25 25 25 25 25 25 25 7 25 25 25 25 25 25 25 25 25 25 25 25 25 25 25 7 25 25 25 25 25 25 25 25 25 25 25 25 25 25 25 7 25 25 25 25 25 25 25 25 25 25 25 25 25 25 25 7 25 25 25 25 25 25 25 25 25 25 25 25 25 25 25 7 25 25 25 25 25 25 25 25 25 25 25 25 25 25 25 7 25 25 25
7 25 26 25 25 25 25 25 25 25 25 25 26 25 25 25 7 25 26 25 25 25 25 25 25 25 25 25 26 25 25 25 7 25 26 25 25 25 25 25 25 25 25 25 26 25 25 25 7 25 26 25 25 25 25 25 25 25 25 25 26 25 25 25 7 25 26 25 25 25 25 25 25 25 25 25 26 25 25 25 7 25 26 25 25 25 25 25 25 25 25 25 26 25 25 25 7 25 26 25
7 25 25 25 25 25 25 25 25 25 25 25 25 25 25 25 7 25 25 25 25 25 25 25 25 25 25 25 25 25 25 25 7 25 25 25 25 25 25 25 25 25 25 25 25 25 25 25 7 25 25 25 25 25 25 25 25 25 25 25 25 25 25 25 7 25 25 25 25 25 25 25 25 25 25 25 25 25 25 25 7 25 25 25 25 25 25 25 25 25 25 25 25 25 25 25 7 25 25 25
7 25 25 25 25 25 25 25 25 25 25 25 25 25 25 25 7 25 25 25 25 25 25 25 25 25 25 25 25 25 25 25 7 25 25 25 25 25 25 25 25 25 25 25 25 25 25 25 7 25 25 25 25 25 25 25 25 25 25 25 25 25 25 25 7 25 25 25 25 25 25 25 25 25 25 25 25 25 25 25 7 25 25 25 25 25 25 25 25 25 25 25 25 25 25 25 7 25 25 25
7 25 25 25 25 25 25 25 25 25 25 25 25 25 25 25 7 25 25 25 25 25 25 25 25 25 25 25 25 25 25 25 7 25 25 25 25 25 25 25 25 25 25 25 25 25 25 25 7 25 25 25 25 25 25 25 25 25 25 25 25 25 25 25 7 25 25 25 25 25 25 25 25 25 25 25 25 25 25 25 7 25 25 25 25 25 25 25 25 25 25 25 25 25 25 25 7 25 25 25
7 25 25 25 25 25 25 25 25 25 25 25 25 25 25 25 7 25 25 25 25 25 25 25 25 25 25 25 25 25 25 25 7 25 25 25 25 25 25 25 25 25 25 25 25 25 25 25 7 25 25 25 25 25 25 25 25 25 25 25 25 25 25 25 7 25 25 25 25 25 25 25 25 25 25 25 25 25 25 25 7 25 25 25 25 25 25 25 25 25 25 25 25 25 25 25 7 25 25 25
5 1 1 1 1 1 1 5 1 1 1 1 1 1 1 5 5 1 1 1 1 1 1 5 1 1 1 1 1 1 1 5 5 1 1 1 1 1 1 5 1 1 1 1 1 1 1 5 5 1 1 1 1 1 1 5 1 1 1 1 1 1 1 5 5 1 1 1 1 1 1 5 1 1 1 1 1 1 1 5 5 1 1 1 1 1 1 5 1 1 1 1 1 1 1 5 5 1 1 1
11 7 7 7 7 7 7 11 7 7 7 7 7 7 7 11 11 7 7 7 7 7 7 11 7 7 7 7 7 7 7 11 11 7 7 7 7 7 7 11 7 7 7 7 7 7 7 11 11 7 7 7 7 7 7 11 7 7 7 7 7 7 7 11 11 7 7 7 7 7 7 11 7 7 7 7 7 7 7 11 11 7 7 7 7 7 7 11 7 7 7 7 7 7 7 11 11 7 7 7
7 25 25 25 25 25 25 25 25 25 25 25 25 25 25 25 7 25 25 25 25 25 25 25 25 25 25 25 25 25 25 25 7 25 25 25 25 25 25 25 25 25 25 25 25 25 25 25 7 25 25 25 25 25 25 25 25 25 25 25 25 25 25 25 7 25 25 25 25 25 25 25 25 25 25 25 25 25 25 25 7 25 25 25 25 25 25 25 25 25 25 25 25 25 25 25 7 25 25 25
7 25 26 25 25 25 25 25 25 25 25 26 25 25 25 25 7 25 26 25 25 25 25 25 25 25 25 26 25 25 25 25 7 25 26 25 25 25 25 25 25 25 25 26 25 25 25 25 7 25 26 25 25 25 25 25 25 25 25 26 25 25 25 25 7 25 26 25 25 25 25 25 25 25 25 26 25 25 25 25 7 25 26 25 25 25 25 25 25 25 25 26 25 25 25 25 7 25 26 25
7 25 25 25 25 25 25 25 25 25 25 25 25 25 25 25 7 25 25 25 25 25 25 25 25 25 25 25 25 25 25 25 7 25 25 25 25 25 25 25 25 25 25 25 25 25 25 25 7 25 25 25 25 25 25 25 25 25 25 25 25 25 25 25 7 25 25 25 25 25 25 25 25 25 25 25 25 25 25 25 7 25 25 25 25 25 25 25 25 25 25 25 25 25 25 25 7 25 25 25
7 25 25 25 25 26 25 25 25 25 26 25 25 25 25 25 7 25 25 25 25 26 25 25 25 25 26 25 25 25 25 25 7 25 25 25 25 26 25 25 25 25 26 25 25 25 25 25 7 25 25 25 25 26 25 25 25 25 26 25 25 25 25 25 7 25 25 25 25 26 25 25 25 25 26 25 25 25 25 25 7 25 25 25 25 26 25 25 25 25 26 25 25 25 25 25 7 25 25 25
7 25 25 25 25 25 25 25 25 25 25 25 25 25 25 25 7 25 25 25 25 25 25 25 25 25 25 25 25 25 25 25 7 25 25 25 25 25 25 25 25 25 25 25 25 25 25 25 7 25 25 25 25 25 25 25 25 25 25 25 25 25 25 25 7 25 25 25 25 25 25 25 25 25 25 25 25 25 25 25 7 25 25 25 25 25 25 25 25 25 25 25 25 25 25 25 7 25 25 25
7 25 26 25 25 25 25 25 25 25 25 25 26 25 25 25 7 25 26 25 25 25 25 25 25 25 25 25 26 25 25 25 7 25 26 25 25 25 25 25 25 25 25 25 26 25 25 25 7 25 26 25 25 25 25 25 25 25 25 25 26 25 25 25 7 25 26 25 25 25 25 25 25 25 25 25 26 25 25 25 7 25 26 25 25 25 25 25 25 25 25 25 26 25 25 25 7 25 26 25
7 25 25 25 25 25 25 25 25 25 25 25 25 25 25 25 7 25 25 25 25 25 25 25 25 25 25 25 25 25 25 25 7 25 25 25 25 25 25 25 25 25 25 25 25 25 25 25 7 25 25 25 25 25 25 25 25 25 25 25 25 25 25 25 7 25 25 25 25 25 25 25 25 25 25 25 25 25 25 25 7 25 25 25 25 25 25 25 25 25 25 25 25 25 25 25 7 25 25 25
7 25 25 25 25 25 25 25 25 25 25 25 25 25 25 25 7 25 25 25 25 25 25 25 25 25 25 25 25 25 25 25 7 25 25 25 25 25 25 25 25 25 25 25 25 25 25 25 7 25 25 25 25 25 25 25 25 25 25 25 25 25 25 25 7 25 25 25 25 25 25 25 25 25 25 25 25 25 25 25 7 25 25 25 25 25 25 25 25 25 25 25 25 25 25 25 7 25 25 25
7 25 25 25 25 25 25 25 25 25 25 25 25 25 25 25 7 25 25 25 25 25 25 25 25 25 25 25 25 25 25 25 7 25 25 25 25 25 25 25 25 25 25 25 25 25 25 25 7 25 25 25 25 25 25 25 25 25 25 25 25 25 25 25 7 25 25 25 25 25 25 25 25 25 25 25 25 25 25 25 7 25 25 25 25 25 25 25 25 25 25 25 25 25 25 25 7 25 25 25
7 25 25 25 25 25 25 25 25 25 25 25 25 25 25 25 7 25 25 25 25 25 25 25 25 25 25 25 25 25 25 25 7 25 25 25 25 25 25 25 25 25 25 25 25 25 25 25 7 25 25 25 25 25 25 25 25 25 25 25 25 25 25 25 7 25 25 25 25 25 25 25 25 25 25 25 25 25 25 25 7 25 25 25 25 25 25 25 25 25 25 25 25 25 25 25 7 25 25 25
5 1 1 1 1 1 1 5 1 1 1 1 1 1 1 5 5 1 1 1 1 1 1 5 1 1 1 1 1 1 1 5 5 1 1 1 1 1 1 5 1 1 1 1 1 1 1 5 5 1 1 1 1 1 1 5 1 1 1 1 1 1 1 5 5 1 1 1 1 1 1 5 1 1 1 1 1 1 1 5 5 1 1 1 1 1 1 5 1 1 1 1 1 1 1 5 5 1 1 1
11 7 7 7 7 7 7 11 7 7 7 7 7 7 7 11 11 7 7 7 7 7 7 11 7 7 7 7 7 7 7 11 11 7 7 7 7 7 7 11 7 7 7 7 7 7 7 11 11 7 7 7 7 7 7 11 7 7 7 7 7 7 7 11 11 7 7 7 7 7 7 11 7 7 7 7 7 7 7 11 11 7 7 7 7 7 7 11 7 7 7 7 7 7 7 11 11 7 7 7
7 25 25 25 25 25 25 25 25 25 25 25 25 25 25 25 7 25 25 25 25 25 25 25 25 25 25 25 25 25 25 25 7 25 25 25 25 25 25 25 25 25 25 25 25 25 25 25 7 25 25 25 25 25 25 25 25 25 25 25 25 25 25 25 7 25 25 25 25 25 25 25 25 25 25 25 25 25 25 25 7 25 25 25 25 25 25 25 25 25 25 25 25 25 25 25 7 25 25 25
7 25 26 25 25 25 25 25 25 25 25 26 25 25 25 25 7 25 26 25 25 25 25 25 25 25 25 26 25 25 25 25 7 25 26 25 25 25 25 25 25 25 25 26 25 25 25 25 7 25 26 25 25 25 25 25 25 25 25 26 25 25 25 25 7 25 26 25 25 25 25 25 25 25 25 26 25 25 25 25 7 25 26 25 25 25 25 25 25 25 25 26 25 25 25 25 7 25 26 25
